5 6
#####
##..#
#...#
#.#.#
#...#
#####